@@@@@@..@.@@@@@@...@@@@@.......
...@......@@..@..@..@@.@...E..@
...@...@......@@.....@........@
..@@.@@@.@@@.@@@@.@..@.@.@.@@..
@..@@..@.@@...@.@.@@...@...@..@
@@..@@.@....@.....@@@.@@.@@@.@@
@.@.@....@..@.@@@..@..@..@.@...
@.@..@.@@@@@@@@.@@@@@....@.@@..
..@........@@A.....@@@@@...@@..
....@@.@@@..@@.@.@@@...@@.@@..@
..@.@................@..@..@B.@
..@@@@@@@@@@@@@@@......@@@@@@@@
