@@@@@@..@.@@@@@@...@@@@@.......
...@......@@..@..@..@@.@......@
...@...@......@@.....@........@
..@@.@@@.@@@.@@@@.@..@.@.@.@@..
@..@@..@.@@...@.@.@@...@...@..@
@@..@@.@....@.....@@@.@@.@@@.@@
@.@.@....@..@.@@@..@..@..@.@...
@.@..@.@@@@@@@@.@@@@@....@.@@..
..@........@@A....E@@@@@...@@..
....@@.@@@..@@.@.@@@...@@.@@..@
..@.@................@..@..@B.@
..@@@@@@@@@@@@@@@......@@@@@@@@
